18,18,18,18,18,18,18,18,18,18,18,18,18,18,18,18,18,18,18,18,18,18,18,18,18,18,18,18,18,18,18,18
18,18,18,0,8,8,8,8,8,8,8,8,8,8,8,8,8,8,8,8,8,8,8,8,8,8,8,8,1,18,18,18
18,0,8,5,25,13,13,13,13,13,25,13,13,13,13,25,25,13,13,13,13,13,13,25,13,13,13,25,6,8,1,18
18,5,13,14,34,34,17,34,22,26,34,17,34,34,34,22,34,34,17,26,26,17,22,34,17,34,22,22,12,13,6,18
18,9,34,22,34,34,26,22,34,34,34,22,17,22,17,26,34,34,34,26,17,34,34,34,34,26,34,34,17,34,7,18
18,9,34,34,34,34,2,3,3,3,3,3,3,3,3,4,34,34,34,34,26,34,34,22,34,34,34,34,26,34,7,18
18,9,34,22,34,34,7,8,8,8,8,8,8,1,18,9,34,17,34,34,34,22,22,34,34,17,34,34,34,34,7,18
18,9,17,26,26,34,12,13,25,13,13,25,13,6,18,9,34,34,34,34,34,34,34,34,34,34,34,34,26,26,7,18
18,9,22,34,34,34,34,34,34,34,34,34,34,7,18,9,34,34,34,34,34,34,22,34,22,26,22,34,34,34,7,18
18,9,26,34,34,34,34,17,34,26,34,34,26,7,18,9,22,34,34,34,34,34,34,34,34,34,34,34,34,34,7,18
18,9,34,34,34,34,34,22,34,34,26,26,34,7,18,9,34,34,34,34,22,34,34,34,26,26,34,34,34,17,7,18
18,9,26,34,34,34,34,34,34,17,34,34,26,7,18,9,34,34,34,34,34,34,34,34,34,34,34,34,34,34,7,18
18,9,34,34,34,34,26,26,34,34,34,34,34,7,18,9,34,34,34,34,34,34,34,34,34,34,34,34,34,26,7,18
18,9,34,34,34,26,34,34,34,34,17,34,34,7,18,9,34,34,34,34,34,34,34,34,34,34,34,34,34,26,7,18
18,9,34,34,34,34,34,34,34,34,34,34,34,7,18,9,34,17,34,34,34,34,34,34,34,34,34,34,34,17,7,18
18,9,34,17,34,34,34,34,34,34,17,17,34,7,18,10,3,3,3,3,3,3,4,22,34,22,34,34,26,22,7,18
18,9,34,34,34,34,34,34,34,34,34,34,34,7,18,18,18,18,18,18,18,18,9,34,34,34,34,34,34,34,7,18
18,9,34,34,34,26,34,34,22,34,34,34,34,7,8,8,8,8,8,8,8,8,9,34,34,17,34,34,34,22,7,18
18,9,34,34,34,26,17,34,34,34,22,34,34,12,25,13,25,13,13,25,13,25,14,17,34,34,34,34,22,22,7,18
18,9,26,34,34,34,34,34,26,34,34,34,34,34,34,17,34,34,34,34,34,22,34,34,17,22,34,34,26,22,7,18
18,9,34,34,34,26,26,34,34,34,34,34,34,34,34,34,34,34,34,34,34,34,34,22,34,34,34,34,34,26,7,18
18,9,26,22,34,22,34,34,34,34,34,34,34,34,34,34,34,34,22,34,34,34,34,34,34,26,26,34,22,26,7,18
18,9,34,34,34,34,34,34,34,34,34,22,34,34,34,34,34,34,34,34,34,34,34,34,34,34,34,34,34,17,7,18
18,9,26,17,22,34,26,34,34,34,26,26,34,34,34,34,22,34,34,34,34,34,34,34,34,34,34,34,26,34,7,18
18,9,17,34,34,34,34,34,34,34,17,34,26,34,34,34,34,34,34,34,34,34,34,34,34,34,34,22,26,34,7,18
18,9,22,26,34,34,34,34,34,34,34,34,34,34,34,34,34,34,17,26,34,34,17,17,34,17,34,34,34,26,7,18
18,9,34,17,34,34,17,34,34,34,34,34,34,22,17,34,34,34,34,26,22,34,34,34,22,17,26,17,22,22,7,18
18,9,26,34,34,34,34,34,34,34,34,34,34,34,34,26,34,34,34,34,34,34,34,34,34,34,34,34,34,17,7,18
18,9,34,22,34,22,34,34,34,34,34,34,22,34,34,34,34,34,34,34,22,17,34,34,34,34,34,34,26,2,11,18
18,10,3,4,34,34,34,34,34,34,34,34,34,34,34,34,34,17,34,34,34,34,34,34,34,34,34,34,34,7,18,18
18,18,18,10,3,3,3,3,3,3,3,3,3,3,3,3,3,3,3,3,3,3,3,3,3,3,3,3,3,11,18,18
18,18,18,18,18,18,18,18,18,18,18,18,18,18,18,18,18,18,18,18,18,18,18,18,18,18,18,18,18,18,18,18
